11111111111111111111111111111111110
23330060033300033330003330000000000
20001111100011100001110001111160000
20001000000100010010001001000110000
20001001100100010010001001000010000
20001004100100010010001001040110000
20001111100011100001110001111100000
20000000000000000000000000000000000
23336333333033303330660330330000000
20001000000100010001111001001000000
20001000000100010010000001010000000
20001000000100010010000001100000000
20001000400104010010440001016000000
20001111100011100001111001001000000
20000000000000000000000000000000000
20000000000000000000000000000000000
20000000000000000000000000000000000
20000000000000000000000000000000000
20660000000000000454000000000000660
11111111111111111111111111111111111
