11111111111111111111111111111111100
14000000000000041112000012100000200
11111111211111111102006002000002211
11140000200004111032111112000021211
11111111211111110302111112000211211
11111400200411103002000002002111211
11111111211111230002000002021111211
11000000200033200012100002211111211
11211111111103205002000002111111211
11211111111030211112000021111111211
11211111110300211112000211111111211
11211111103000200002002111111111211
11211111230001210002020000000000211
11211110200000200002211112111111111
11211103200600200002111402000411111
11211030211111200021111112111111111
11210300211111200211140002000004111
11233000200000202111111112111111111
11200001210000221114000002000000041
10200000200000211111111111111111111
