11111111111120000000211111111111110
10000000000000000000000000000000000
10000000000000012160000000000000000
11111111111111112111111111111111211
00000000000000002000000001210001201
00000000000000002000000000200001111
33333333333333332000000000200003333
20000000000000012160000000200000000
21111111111111111111111111211111111
23333333333333333330000000233333332
20000000000000000000000000200000002
20000033000000330000000000200000002
20111100111111001210000333200111112
20100100100001001211111100200100012
20100100100001001200000100200100012
20111100121111001111111100200111112
20333333323333333333333333233333332
10000000020000000000000000200000001
10000000020000000500400600200000001
11111111111111111111111111111111111
