01111111111111100000111111111111110
00000000000000000000000000000000000
23330600330000000000000003300603332
20001111111111111111111111111110002
20011001000011111111111000000011002
20010000030001111111110003000001002
20011401203000110401100030210411002
20001111200300311111300300211110002
20000000200003001110030000200000002
20000000200033330303333000200000002
20000000200300003330000300200000002
20000000200000330303300000200000002
20000000211111000000011111200000002
20000000111110000000001111100000002
20000001111100000200000111110000002
20000011111000002220000011111000002
20000111110000022022000001111100002
20000000000000220002200000000000002
20000000000002200500220000000000002
11111111111111111111111111111111111
