11111111111111100000111111111111110
10000000000000100000100000000000000
10000000000000111011100000000000000
10000000000000000000000000000000000
10040000006000000000000060000004000
11111120011111111011111111002111111
10000020000000000000000000002000001
10000020000000000000000000002000001
10200020000000000000000000002000201
10333323333333333033333333332333301
10000000000000000200000000000000001
10000000000000000200000000000000001
10000000000040000200004000000000001
10023111111110000200001111111132001
10020000000000000200000000000002001
10020004000000000200000000040002001
10011111111200000200000211111111001
10000000000200000200000200000000001
10000000000200000200000200000000051
11111111111111111111111111111111111
